1000000000001111100000000001112222111000000000011111000000000001
1000000000001111100000000001112222111000000000011111000000000001
1000000000001111100000000001112222111000000000011111000000000001
1000000000001111100000000001112222111000000000011111000000000001
1000000000001111100000000001112222111000000000011111000000000001
1000000000001111111111112211112222111122111111111111000000000001
1122111111111111111111112211112222111122111111111111111111112211
2222222222222222222222222222222222222222222222222222222222222222
2222222222222222222222222222222222222222222222222222222222222222
4422444444444444444444444444442222444444444444444444444444442244
3322333333333333333333333333332222333333333333333333333333332233
3322333333333333333333333333332222333333333333333333333333332233
3322333333333333333333333333332222333333333333333333333333332233
3322333333333333333333333333332222333333333333333333333333332233
4422444444444444444444444444442222444444444444444444444444442244
2222222222222222222222222222222222222222222222222222222222222222
2222222222222222222222222222222222222222222222222222222222222222
1122111111111111111111112211112222111122111111111111111111112211
1000000000001111111111112211112222111122111111111111000000000001
1000000000001111100000000001112222111000000000011111000000000001
1000000000001111100000000001112222111000000000011111000000000001
1000000000001111100000000001112222111000000000011111000000000001
1000000000001111100000000001112222111000000000011111000000000001
1000000000001111100000000001112222111000000000011111000000000001

0100000000010030010000000010030000300100000000100300100000000010
0100000000010030010000000010030000300100000000100300100000000010
0100333033310030010000030020030000300200300000100300133303330010
0100000000010030010000030010030000300100300000100300100000000010
0100000000010030011222110010030000300100112221100300112222113310
0133112222110030000000000000030000300000000000000300000000000000
0000000000000030000000000000030000300000000000000300000000000000
0000000000000000000000000000000000000000000000000000000000000000
0000000000000000000000000000000000000000000000000000000000000000
1100110000001100000011000000110000110000001100000011000000110011
0000000000000000000000000000000000000000000000000000000000000000
0000000000000000000000000000000000000000000000000000000000000000
0000000000000000000000000000000000000000000000000000000000000000
0000000000000000000000000000000000000000000000000000000000000000
1100110000001100000011000000110000110000001100000011000000110011
0000000000000000000000000000000000000000000000000000000000000000
0000000000000000000000000000000000000000000000000000000000000000
0000000000000030000000000000030000300000000000000300000000000000
0133112222110030000000000000030000300000000000000300112222113310
0100000000010030011222110010030000300100112221100300100000000010
0100000000010030010000030010030000300100300000100300100000000010
0100333033310030010000030020030000300200300000100300133303330010
0100000000010030010000000010030000300100000000100300100000000010
0100000000010030010000000010030000300100000000100300100000000010

10-1 13-1 51-1 54-1
10-23 13-23 51-23 54-23