1113111111111111
1113112222222222
1113112222222222
1133112200000011
1131112200000011
1131112200000011
1331112200000011
1311112200000011

0000000000000000
0000000000000000
0000000000000000
0000000011331100
0000000020000100
0000000020000100
0000000020000200
0000000011111100