11131111111111111111111111111111
11131122222222222222222222222222
11131122222222222222222222222222
11331122000000111111111111111111
11311122000000111111111111111111
11311122000000111111111111111111
13311122000000111110000000000000
13111122000000111110000000000000
13331122111111111110000000000000
11131122222222222220000000000000
11131122222222222220000000000000
11331122000000111110000000000000
11311122000000111110000000000000
11311122000000111110000000000000
13311122000000111111111111111111
13111122000000111111111111111111

00000000000000000000000000000000
00000000000000000000000000000000
00000000000000000000000000000000
00000000113311000000000000000000
00000000200001000000000000000000
00000000200001000000000000000000
00000000200002000001222122212221
00000000111111000001000000000001
00000000000000000031001000000001
00000000000000000000001000000001
00000000000000000000001000000001
00000000113311000031001000000001
00000000200001000001000000000001
00000000200001000001222122212221
00000000200002000000000000000000
00000000111111000000000000000000